UUU	Phenylalanin	F
UUC	Phenylalanin	F
UUA	Leucin	L
UUG	Leucin	L
UCU	Serin	S
UCC	Serin	S
UCA	Serin	S
UCG	Serin	S
UAU	Tyrosin	T
UAC	Tyrosin	T
UAA	Stop	Stop
UAG	Stop	Stop
UGU	Cystein	C
UGC	Cystein	C
UGA	Stop	Stop
UGG	Tryptophan	W
CUU	Leucin	L
CUC	Leucin	L
CUA	Leucin	L
CUG	Leucin	L
CCU	Prolin	P
CCC	Prolin	P
CCA	Prolin	P
CCG	Prolin	P
CAU	Histidin	H
CAC	Histidin	H
CAA	Glutamin	Q
CAG	Glutamin	Q
CGU	Arginin	R
CGC	Arginin	R
CGA	Arginin	R
CGG	Arginin	R
AUU	Isoleucin	I
AUC	Isoleucin	I
AUA	Isoleucin	I
AUG	Methionin*	M
ACU	Threonin	T
ACC	Threonin	T
ACA	Threonin	T
ACG	Threonin	T
AAU	Asparagin	N
AAC	Asparagin	N
AAA	Lysin	K
AAG	Lysin	K
AGU	Serin	S
AGC	Serin	S
AGA	Arginin	R
AGG	Arginin 	R
GUU	Valin	V
GUC	Valin	V
GUA	Valin	V
GUG	Valin	V
GCU	Alanin	A
GCC	Alanin	A
GCA	Alanin	A
GCG	Alanin	A
GAU	Asparagins채ure	D
GAC	Asparagins채ure	D
GAA	Glutamins채ure	E
GAG	Glutamins채ure	E
GGU	Glycin	G
GGC	Glycin	G
GGA	Glycin	G
GGG	Glycin	G
